.-+-+-+-+-+-.
|           |
+  +-.+  +  +
g  |     |  g
+  +  +-.+.-+
g  |        g
+  +.-+-.+  +
|        |  |
.-+-+-+-+-+-.