###############################
#S....#.......................#
#.##..#.#####.....#######.....#
#.#.........#.....#...........#
#.#.#####...#####.#.........#.#
#.#.............#.#.....#.#.#.#
#.#####........ #.#####.#.#.###
#.....#.#.......#.#.#.#####...#
###.#.#.#####...#.#.#.#.......#
#...#.#.....#...#.#...#....####
#.###.#####.#.#.#####.#.......#
#...#.....#.#.#..........#..###
###.#####.#.#.#####...####....#
#.......#...#.....#...####...##
#.#####.#######...#...#.......#
#.....#.............#.#...#####
###################G#........##
###############################
