.--+--+--+--.
|           |
+  +--+  +  +
|  |     |  |
+  +  +--+--+
|  |        |
+  +--+--+  +
|        |  |
.--+--+--+--.